0001110000013100111101001340411111154031001411110013100000111000
0011110011100100115401001114011111104011113400111133731111111111
0111110001501110010400101110101113101001134001011300040111111111
0011110000100111111000011007310110047001111051110010010000111100
1111111110001001101014311000043110101431100010011111150100001111
